

    
       
SO   lll.xpm  NO llll.xpm  EA llll.xpm  WE c.xpm  F 5 , 5, 5   C 5 , 5, 5

1111111
10N0111
11111 1

