NO ./srcs/assets/textures/north_texture.xpm
WE ./srcs/assets/textures/west_texture.xpm
SO ./srcs/assets/textures/south_texture.xpm
EA ./srcs/assets/textures/east_texture.xpm

C 247,247,255
F 194,196,195

1111111111111111111111111111111111111111111111111111111
1000000000000000000000000000000000000000000000000000001
100N001111111111110000000000000000000000000000000000001
1000000000000000001000000000000000000000000000000000001
1000000000000000000000000000000000000000000000000000001
1000000000000000001000000000000111110000000000000000011
1000001111111111110000000000000000000000000000000000001
1000000000000000000000000000000011110000000000000000001
1000000000000000000000000000000000000000000000000000001
1000000000000000000000000000000000000000000000000000001
1000000000000000000000000000000000000000000000000000001
1000000000000000000000000000000000000000000000000000001
1000000000000000000000000000000000000000000000000000001
1111111111111111111111111111111111111111111111111111111
