NO ./srcs/Assets/Textures/texture1.xpm
SO ./srcs/Assets/Textures/texture2.xpm
WE ./srcs/Assets/Textures/texture3.xpm
EA ./srcs/Assets/Textures/texture4.xpm

C 194,196,195
F 247,247,247

111111111111111111
100000000000000001
100000000000000001
100001111111110001
100000000000010001
100000000000000001
100000000000000001
100000000000000001
100000000000000001
100000000000000001
1000000000N0000001
100000000000000001
100000000000000001
100000000000000001
111111111111111111

