NO srcs/assets/textures/north_texture.xpm
WE ./srcs/assets/textures/west_texture.xpm
SO ./srcs/assets/textures/south_texture.xpm
EA ./srcs/assets/textures/east_texture.xpm

C 247,247,255
F 194,196,195


111111111111111111111111
100000000000000000000011
100100000100010000000011
100100000000000001000001
11111111011000100010010111111
10000000000000000010000000111
111100W0001001001000000001001
11110000100000000110101000001
11000000110101000000000001001
10001010000100100000010001001
10000100010000100001010010001
11000001110101011111011110101
11110111 1000001 111011 10111
11111111 1111111 111111 11111
