NO ./srcs/assets/textures/north_texture.xpm
WE ./srcs/assets/textures/west_texture.xpm
SO ./srcs/assets/textures/south_texture.xpm
EA ./srcs/assets/textures/east_texture.xpm

C 247,247,255
F 194,196,195

111111111111111111111111111
100000000000000000000000001
100N00111111111111000000001
100000000000000000100000001
100000000000000000000000001
100000000000000000100000011
100000111111111111000000001
100000000000000000000000001
111111111111111111111111111
