NO ./textures/64/nord.xpm 
SO ./textures/64/sud.xpm
EA ./textures/64/EW.xpm


C 200,000,00
F 000,000,000

WE ./textures/64/EW.xpm
  111111111111  11   
   1000000N1111       
   11100000000011     
111100001011011  1       
11111111 11111111     
1001001111
1111111
