NO ./srcs/assets/textures/north_texture.xpm
WE ./srcs/assets/textures/west_texture.xpm
SO ./srcs/assets/textures/south_texture.xpm
EA ./srcs/assets/textures/east_texture.xpm

C 247,247,255
F 194,196,195

11111111111111111111111111111111111111111111111111111111111111111111111
10000000000000000000000000000000000000000000000000000000000000000000001
100N0011111111111100000000000000000000000000000000000000000000000000001
10000000000000000010000000000000000000000000000000000000000000000000001
10000000000000000000000000000000000000000000000000000000000000000000001
10000000000000000010000000000000000000000000000000000000000000000000011
10000011111111111100000000000000000000000000000000000000000000000000001
10000000000000000000000000000000000000000000000000000000000000000000001
10000000000000000000000000000000000000000000000000000000000000000000001
10000000000000000000000000000000000000000000000000000000000000000000001
10000000000000000000000000000000000000000000000000000000000000000000001
10000000000000000000000000000000000000000000000000000000000000000000001
10000000000000000000000000000000000000000000000000000000000000000000001
11111111111111111111111111111111111111111111111111111111111111111111111
