NO ./srcs/Assets/Textures/texture1.xpm
SO ./srcs/Assets/Textures/texture2.xpm
WE ./srcs/Assets/Textures/texture3.xpm
EA ./srcs/Assets/Textures/texture4.xpm

C 247,247,247
F 194,196,195

11111111111111111
100000000100000001
100000001 10000001
100011111111100001
1000000000000010001
100000000000000001
100000000000000001
100000000000000001
100000000000000001
100000000000000001
100000000N00000001
100000000000010001
100001111111100001
100000000000000001
111111111111111111

