NO ./srcs/Assets/Textures/texture1.xpm
SO ./srcs/Assets/Textures/texture2.xpm
WE ./srcs/Assets/Textures/texture3.xpm
EA ./srcs/Assets/Textures/texture4.xpm

C 247,247,247
F 194,196,195

11111111111111111111111111111111111111111111111111111
10000000010000000000000000000000000000000000000000001
100000001 1000000000000000000000000000000000000000001
10001111111110000000000000000000000000000000000000001
10000000000000100000000000000000000000000000000000001
10000000000000000000000000000000000000000000000000001
10000000000000000000000000000000000000000000000000001
10000000000000000000000000000000000000000000000000001
10000000000000000000000000000000000000000000000000001
10000000000000000000000000000000000000000000000000001
100000000N0000000000000000000000000000000000000000001
10000000000001000000000000000000000000000000000000001
10000111111110000000000000000000000000000000000000001
10000000000000000000000000000000000000000000000000001
11111111111111111111111111111111111111111111111111111

