NO srcs/assets/textures4/north_texture.xpm
WE ./srcs/assets/textures4/west_texture.xpm
SO ./srcs/assets/textures4/south_texture.xpm
EA ./srcs/assets/textures4/east_texture.xpm

C 247,247,255
F 194,196,195


        111111111111111111111111
        1000000000110000000000001
        1011000001110000000000001
        1001000000000000000000001
11111111011000001110000000000001
1E00000100011000001110111111111111
11111111111111111100000010001
1111011110011 0 11101010010001
11000000111101111100000010001
10000000000000001100000010001
10000000000000001101010010001
1100000111010101111101111000111
11110111 1110101 101111010001
11111111 1111111 111111111111
