NO ./srcs/assets/textures/north_texture.xpm
WE ./srcs/assets/textures/west_texture.xpm
SO ./srcs/assets/textures/south_texture.xpm
EA ./srcs/assets/textures/east_texture.xpm

C 247,247,255
F 194,196,195


1111
1N01
1001
1111
