NO ./srcs/Assets/Textures/purplestone.xpm
SO ./srcs/Assets/Textures/bluestone.xpm
WE ./srcs/Assets/Textures/greystone.xpm
EA ./srcs/Assets/Textures/redbrick.xpm

F 220,100,0
C 225,30,0

1111111111111111111111111
1000000000110000000000001
1011000001110000000000001
1001000000000000000000001
1111111110110000011100000
1000000000110000011101111
1111011111111101110000001
1111011111111101110101001
1100000011010101110000001
1000000000000000000000001
1000000000000000000100001
100000000000E000000100001
1000000000000000000100001
1000000000000000000100001
1100000111010101111100001
1111111111111111111111111
