NO ./srcs/Assets/Textures/purplestone.xpm
SO ./srcs/Assets/Textures/bluestone.xpm
WE ./srcs/Assets/Textures/greystone.xpm
EA ./srcs/Assets/Textures/redbrick.xpm



F 200,200,200


            C 255,200,200





    1111111
    1001001
    1001001
    1011111
    1001001
    1N01001
  1111111
