NO srcs/assets/textures3/north_texture.xpm
WE ./srcs/assets/textures3/west_texture.xpm
SO ./srcs/assets/textures3/south_texture.xpm
EA ./srcs/assets/textures3/east_texture.xpm

C 247,247,255
F 194,196,195


       111111111111111111111111
      1000000000000000000000111
      1001000001000100000000111
      1001000000000000010000001
1111111101100010001001011111111
10000000000000000010000000111
111100S0001001001000000001001
11110000100000000110101000001
11000000110101000000000001001
10001010000100100000010001001
10000100010000100001010010001
11000001110101011111011110101
11110111 1000001 111011 10111
11111111 1111111 111111 11111

111
101
111
