NO ./srcs/Assets/Textures/texture1.xpm
SO ./srcs/Assets/Textures/texture2.xpm
WE ./srcs/Assets/Textures/texture3.xpm
EA ./srcs/Assets/Textures/texture4.xpm

C 194,196,195
F 247,247,247

1111111111111111111111111
1000000000110000000000001
1011000001110000000000001111111111111111111111111111111111111111111111111111111111111111111111111111111111111111111111111111111111111111111111111111111111111111111111111111111111111111111111111111111111111111111111111111111111111111111111111111111111111111111111111111111111111111111111111111111111111111111111111111111111111111111111111111111111
1001000000000000000000000000000110000000000000000001100000000000000000011000000000000000000110000000000000000001100000000000000000011000000000000000000110000000000000000001100000000000000000011000000000000000000110000000000000000001100000000000000000011000000000000000000110000000000000000001100000000000000000011000000000000000000110000000000001
1011000001110000000000000000000110000000000000000001100000000000000000011000000000000000000110000000000000000001100000000000000000011000000000000000000110000000000000000001100000000000000000011000000000000000000110000000000000000001100000000000000000011000000000000000000110000000000000000001100000000000000000011000000000000000000110000000000001
1001000000000000000000000000000000000000000000000000000000000000000000000000000000000000000000000000000000000000000000000000000000000000000000000000000000000000000000000000000000000000000000000000000000000000000000000000000000000000000000000000000000000000000000000000000000000000000000000000000000000000000000000000000000000000000000000000000001
1111111110110000011100000111111111111111111111111111111111111111111111111111111111111111111111111111111111111111111111111111111111111111111111111111111111111111111111111111111111111111111111111111111111111111111111111111111111111111111111111111111111111111111111111111111111111111111111111111111111111111111111111111111111111111111111111111111111
1000000000110000011101111
1111011111111101110000001
11110111 111101110000001
1111011111111101110101001
1100000011010101110000001
1000000000000000000000001
1000000000000000000100001
100000000000E000000100001
10000000000000000000100001
1000000000000000000100001
1100000111010101111100001
1111111111111111111111111
