NO ./srcs/Assets/Textures/texture1.xpm
SO ./srcs/Assets/Textures/texture2.xpm
WE ./srcs/Assets/Textures/texture3.xpm
EA ./srcs/Assets/Textures/texture4.xpm

C 194,196,195
F 247,247,247

1111111111111111111111111
1000000000110000000000001111111111111111111111111111111111111111111111111111111111111111111111111111111111111111111111111111111111111111111111111111111111111111111111111111111111111111111111111111111111111111111111111111111111111111111111111111
100000000000000000000000000000000000000000000000000000000000000000000000000000000000000000000000000000000000000000000000000000000000000000100000000000000000000000000000000000000000000000000000000000000000000000000000000000000000000000000W000001
1001000000000000000000000100100000000000000000000000000000000000100100000000000000000000010010000000000000000000001001000000000000000000001000100100000000000000000000010010000000000000000000000010010000000000000000000001001000000000000000000001
1111111110110000011100001111111111111111111111111111111111111111111111111111111111111111111111111111111111111111111111111111111111111111111111111111111111111111111111111111111111111111111111111111111111111111111111111111111111111111111111111111
1000000000110000011101111
1111011111111101110000001
11110111 111101110000001
1111011111111101110101001
1100000011010101110000001
1000000000000000000000001
1000000000000000000100001
1000000000000000000100001
1000000000000000000010001
1000000000000000000100001
1100000111010101111100001
1111111111111111111111111
1111111111111111111111111
